




   WWWWWWWWWWWWWWWWWWWWWWW
   W     $    $   $    F W
   W$WWW$WWWWWWW WW WWWW W
   W WWW WWWWWWW$WW      W
   W$   C   $       WWWW$W
   WWW WW WWWWW W WWWWWW W
   WWW$WW WWWWW W WWWWWW W
   WWW WW WW  GHJK  FWWW W
   W  $WW WW WWWDWWW WWW W
   W WWWW WW W     W$WWW W
   W C       W     W    CW
   W WWWWWWW WWWWWWW WWW$W
   W F   $       $      PW
   WWWWWWWWWWWWWWWWWWWWWWW