 WWWWWWWWWWWWWWWWWWWWWWWWWWW
 W$$$$$$$$$$$$W$$$$$$$$$$$$W
 W$WWWW$WWWWW$W$WWWWW$WWWW$W
 WCWWWW$WWWWW$W$WWWWW$WWWWFW
 W$WWWW$WWWWW$W$WWWWW$WWWW$W
 W$$$$$$$$$$$$$$$$$$$$$$$$$W
 W$WWWW$WW$WWWWWWW$WW$WWWW$W
 W$WWWW$WW$WWWWWWW$WW$WWWW$W
 W$$$$$$WW$$$$W$$$$WW$$$$$$W
 WWW$WW$WWWWW W WWWWW$WW$WWW
 WWW$WW$WWWWW W WWWWW$WW$WWW
 WWW$WW$WW  GHJK   WW$WW$WWW
 W$$$WW$WW WWWDWWW WW$WW$$$W
 W$WWWW$WW W     W WW$WWWW$W
 W$$$$$$   W     W   $$$$$$W
 W$WWWW$WW W WWW W WW$WWWW$W
 W$F$WW$WW WWWWWWW WW$WW$$$W
 WWW$WW$WW         WW$WW$WWW
 WWW$WW$WW WWWWWWW WW$WW$WWW
 WWW$WW$WW WWWWWWW WW$WW$WWW
 W$$$$$$$$$$$$W$$$$$$$$$$$$W
 W$WWWW$WWWWW$W$WWWWW$WWWW$W
 W$WWWW$WWWWW$W$WWWWW$WWWW$W
 W$$$WW$$$$$$$P$$$$$$$WW$$CW
 WWW$WW$WW$WWWWWWW$WW$WW$WWW
 WWW$WW$WW$WWWWWWW$WW$WW$WWW
 W$$$$$$WW$$$$W$$$$WW$$$$$$W
 W$WWWWWWWWWW$W$WWWWWWWWWW$W
 W$WWWWWWWWWW$W$WWWWWWWWWW$W
 W$$$$$$$$$$$$$$$$$$$$$$$$$W
 WWWWWWWWWWWWWWWWWWWWWWWWWWW